A,B,C,D,E,F,G
1,2,5,1,4,13,1
2,3,8,2,7,22,0
3,4,11,3,10,31,1
4,5,14,4,13,40,0
5,6,17,5,16,49,1
6,7,20,1,9,43,0
7,8,23,2,12,52,1
8,9,26,3,15,61,0
9,10,29,4,18,70,1
10,11,32,5,21,79,0
